xxxxxxxxxxxxxxxxxxxx
x..................x
x.......xxxxx......x
x.......x b x......x
x.......xx xx......x
x..................x
x..................x
x..................x
x..................x
x.xxxxxxxxxxxxxxx..x
x.....p.......x....x
xxxxx.........xxxxxx
x........h.........x
x..................x
xxxxxxxxxxxxxxxxxxxx